        XXXXXXXX
        X     @X
        X *X* XX
        X *  *X
        XX* * X
XXXXXXXXX * X XXX
X.... XX  *  *  X
XX...   * *     X
X....  XXXXXXXXXX
XXXXXXXX 